********
*      *
* *    *
*  * F *
*   ****
*      E
*      *
********
